!!!!!!!!!!!!p!!!!!!!!!!!!!
!? * !  *     ?   ?    ? !
!       *     *!!!!   *!!!
!!   * !!     ? !!!!!!?!!!
!!                     !!!
!!        *           ?!!!
!!!!!!!!!!!!!!!!!!!!!!!!!!