!!!!!!!!!!! p !!!!!!!!!!!!
!? * !  !     ?   *    ? !
!                        !
!                        !
!       !     !!!!!   *!!!
!!   * !!     * !!!!!!?!!!
!!                     !!!
!!        *           ?!!!
!!                     !!!
!!!!!!!!!!!!!!!!!!!!!!!!!!